{
  "0": 5,
  "1": 10,
  "2": 15,
  "3": 25,
  "4": 35,
  "5": 55,
  "6": 75
}